1011111111
1010100101
1111000100
1000100111
1010111001
1010001001
1111101111
0001010001
1001010010
1111111111
